april=april
august=august
december=decembar
february=februar
friday=petak
january=januar
july=juli
june=juni
march=mart
may=maj
monday=ponedjeljak
november=novembar
october=oktobar
saturday=subota
september=septembar
sunday=nedjelja
thursday=četvrtak
tuesday=utorak
wednesday=srijeda
almost clear=skoro vedro
almost=skoro
and=i
broken=slomljen
clear or partly cloudy=vedro ili djelomično oblačno
clear with haze=vedro sa sumaglicom
clear with light haze=vedro s laganom sumaglicom
clear=vedro
clearings=razvedravanja
cloudy or very cloudy=oblačno ili vrlo oblačno
cloudy with extensive haze=oblačno s gustom maglom
cloudy with local openings=oblačno s lokalnim razvedravanjima
cloudy=oblačno
drizzle=rosulja
due=uslijed
extensive=opsežno
flooding=poplava
fog=magla
foggy weather and very low visibility=maglovito vrijeme i vrlo slaba vidljivost
foggy weather=maglovito vrijeme
foggy=maglovito
freezing fog=smrzavajuća magla
freezing=smrzavanje
gray sky due to low clouds=sivo nebo zbog niskih oblaka
gray=sivo
hail=tuča
half cloudy=djelomično oblačno
half=polovina
haze=izmaglica
heavy rain=obilna kiša
heavy snow and fog=jak snijeg i magla
heavy=teško
high=visoko
irregular clouds with heavy rain=nepravilni oblaci s obilnom kišom
irregular clouds with possible thunderstorm=nepravilni oblaci s mogućom grmljavinom
irregular clouds with possible thunderstorms and fog=nepravilni oblaci s mogućim grmljavinama i maglom
irregular clouds with rain showers=nepravilni oblaci s kišnim pljuskovima
irregular clouds with snow showers=nepravilni oblaci sa snježnim pljuskovima
irregular clouds with snow=nepravilni oblaci sa snijegom
irregular clouds with strong thunderstorm=nepravilni oblaci s jakom grmljavinom
irregular clouds with thunderstorms=nepravilni oblaci s grmljavinama
irregular clouds with very heavy rain=nepravilni oblaci s vrlo obilnom kišom
irregular=nepravilno
light=lagano
local=lokalno
low clouds with some clearings=niski oblaci s ponekim razvedravanjem
low=niski
mostly clear=pretežno vedro
mostly=pretežno
no precipitation=bez padavina
no=ne
openings=otvaranja
or=ili
overcast with drizzle and fog=oblačno s rosuljom i maglom
overcast with drizzle=oblačno s rosuljom
overcast with freezing rain=oblačno sa smrzavajućom kišom
overcast with heavy snow of a blizzard nature and fog=oblačno s jakim snijegom nalik mećavi i maglom
overcast with heavy snow of a blizzard nature=oblačno s jakim snijegom nalik mećavi
overcast with heavy snow=oblačno s jakim snijegom
overcast with light rain and fog=oblačno s laganom kišom i maglom
overcast with light rain=oblačno s laganom kišom
overcast with light snow and fog=oblačno s laganim snijegom i maglom
overcast with light snow=oblačno s laganim snijegom
overcast with possible rain and fog=oblačno s mogućom kišom i maglom
overcast with possible rain=oblačno s mogućom kišom
overcast with rain and fog=oblačno s kišom i maglom
overcast with rain mixed with snow=oblačno s kišom pomiješanom sa snijegom
overcast with rain showers and fog=oblačno s kišnim pljuskovima i maglom
overcast with rain showers=oblačno s kišnim pljuskovima
overcast with rain=oblačno s kišom
overcast with round snow showers=oblačno s kružnim snježnim pljuskovima
overcast with sleet and fog=oblačno s kišom i snijegom te maglom
overcast with sleet=oblačno s kišom i snijegom
overcast with snow and fog=oblačno sa snijegom i maglom
overcast with snow showers and fog=oblačno sa snježnim pljuskovima i maglom
overcast with snow showers=oblačno sa snježnim pljuskovima
overcast with snow storms=oblačno sa snježnim olujama
overcast with snow=oblačno sa snijegom
overcast=oblačno
partly cloudy=djelomično oblačno
partly or partly cloudy with scattered haze=djelomično ili djelomično oblačno s povremenom izmaglicom
partly=djelomično
possible=moguće
precipitation=padavine
rain=kiša
reduced visibility due to fog banks=smanjena vidljivost zbog maglenih naslaga
round=okruglo
scattered clouds and clearings=razbacani oblaci i razvedravanja
scattered clouds with drizzle=razbacani oblaci s rosuljom
scattered clouds with large clearings=razbacani oblaci s velikim razvedravanjima
scattered clouds with light rain=razbacani oblaci s laganom kišom
scattered clouds with light snow=razbacani oblaci s laganim snijegom
scattered clouds with possible rain=razbacani oblaci s mogućom kišom
scattered clouds with possible thunderstorms=razbacani oblaci s mogućim grmljavinama
scattered clouds with rain=razbacani oblaci s kišom
scattered clouds with sleet=razbacani oblaci s kišom i snijegom
severe thunderstorms and fog=jake grmljavine i magla
severe thunderstorms with hail=jake grmljavine s tučom
severe thunderstorms=jake grmljavine
showers=pljuskovi
sky=nebo
sleet=susnježica
slight precipitation=lagane padavine
slight=lagano
snow=snijeg
some=neki
storms=oluje
strong=jak
thin high clouds=tanki visoki oblaci
thin=tanko
thunder=grmljavina
thunderstorm=grmljavina
to=do
very cloudy or overcast with high clouds=vrlo oblačno ili potpuno oblačno s visokim oblacima
very cloudy or overcast=vrlo oblačno ili potpuno oblačno
very cloudy with rain and thunderstorms and fog=vrlo oblačno s kišom, grmljavinama i maglom
very heavy rain, locally flooding=vrlo jaka kiša, lokalno poplave
very=vrlo
visibility=vidljivost
weather=vrijeme
with=s