april=abril
august=agosto
december=diciembre
february=febrero
friday=viernes
january=enero
july=julio
june=junio
march=marzo
may=mayo
monday=lunes
november=noviembre
october=octubre
saturday=sábado
september=septiembre
sunday=domingo
thursday=jueves
tuesday=martes
wednesday=miércoles
almost clear=casi claro
almost=casi
and=y
broken=despejado
clear or partly cloudy=despejado o parcialmente nublado
clear with haze=despejado con niebla
clear with light haze=despejado con ligera niebla
clear=despejado
clearings=despejados
cloudy or very cloudy=nublado o muy nublado
cloudy with extensive haze=nublado con niebla extensa
cloudy with local openings=nublado con aberturas locales
cloudy=nublado
drizzle=llovizna
due=a causa de
extensive=extensa
flooding=inundación
fog=niebla
foggy weather and very low visibility=tiempo con niebla y muy baja visibilidad
foggy weather=tiempo con niebla
foggy=niebla
freezing fog=niebla helada
freezing=helado
gray sky due to low clouds=cielo gris debido a nubes bajas
gray=gris
hail=granizo
half cloudy=medio nublado
half=mitad
haze=neblina
heavy rain=lluvia intensa
heavy snow and fog=nieve pesada y niebla
heavy=intenso
high=alto
irregular clouds with heavy rain=nubes irregulares con lluvia intensa
irregular clouds with possible thunderstorm=nubes irregulares con posible tormenta
irregular clouds with possible thunderstorms and fog=nubes irregulares con posibles tormentas y niebla
irregular clouds with rain showers=nubes irregulares con chubascos
irregular clouds with snow showers=nubes irregulares con chubascos de nieve
irregular clouds with snow=nubes irregulares con nieve
irregular clouds with strong thunderstorm=nubes irregulares con tormenta fuerte
irregular clouds with thunderstorms=nubes irregulares con tormentas
irregular clouds with very heavy rain=nubes irregulares con lluvia muy intensa
irregular=irregular
light=ligero
local=local
low clouds with some clearings=nubes bajas con algunos claros
low=bajo
mostly clear=muy despejado
mostly=mayoría
no precipitation=sin precipitación
no=no
openings=aberturas
or=o
overcast with drizzle and fog=nublado con llovizna y niebla
overcast with drizzle=nublado con llovizna
overcast with freezing rain=nublado con lluvia helada
overcast with heavy snow of a blizzard nature and fog=nublado con nieve pesada de naturaleza de tormenta de nieve y niebla
overcast with heavy snow of a blizzard nature=nublado con nieve pesada de naturaleza de tormenta de nieve
overcast with heavy snow=nublado con nieve intensa
overcast with light rain and fog=nublado con llovizna ligera y niebla
overcast with light rain=nublado con llovizna ligera
overcast with light snow and fog=nublado con nieve ligera y niebla
overcast with light snow=nublado con nieve ligera
overcast with possible rain and fog=nublado con posible lluvia y niebla
overcast with possible rain=nublado con posible lluvia
overcast with rain and fog=nublado con lluvia y niebla
overcast with rain mixed with snow=nublado con lluvia mezclada con nieve
overcast with rain showers and fog=nublado con chubascos de lluvia y niebla
overcast with rain showers=nublado con chubascos de lluvia
overcast with rain=nublado con lluvia
overcast with round snow showers=nublado con chubascos redondeados de nieve
overcast with sleet and fog=nublado con aguanieve y niebla
overcast with sleet=nublado con aguanieve
overcast with snow and fog=nublado con nieve y niebla
overcast with snow showers and fog=nublado con chubascos de nieve y niebla
overcast with snow showers=nublado con chubascos de nieve
overcast with snow storms=nublado con tormentas de nieve
overcast with snow=nublado con nieve
overcast=nublado
partly cloudy=parcialmente nublado
partly or partly cloudy with scattered haze=parcialmente o parcialmente nublado con neblina dispersa
partly=parcialmente
possible=posible
precipitation=precipitación
rain=lluvia
reduced visibility due to fog banks=visibilidad reducida debido a bancos de niebla
round=redondo
scattered clouds and clearings=nubes dispersas y claros
scattered clouds with drizzle=nubes dispersas con llovizna
scattered clouds with large clearings=nubes dispersas con grandes claros
scattered clouds with light rain=nubes dispersas con llovizna ligera
scattered clouds with light snow=nubes dispersas con nieve ligera
scattered clouds with possible rain=nubes dispersas con posible lluvia
scattered clouds with possible thunderstorms=nubes dispersas con posibles tormentas
scattered clouds with rain=nubes dispersas con lluvia
scattered clouds with sleet=nubes dispersas con aguanieve
severe thunderstorms and fog=tormentas severas y niebla
severe thunderstorms with hail=tormentas severas con granizo
severe thunderstorms=tormentas severas
showers=chubascos
sky=cielo
sleet=aguanieve
sleets=aguanieve
slight precipitation=precipitación ligera
slight=ligero
snow=nieve
some=algunos
storms=tormentas
strong=fuerte
thin high clouds=nubes altas delgadas
thin=delgado
thunder=trueno
thunderstorm=tormenta
to=a
very cloudy or overcast with high clouds=muy nublado o cubierto con nubes altas
very cloudy or overcast=muy nublado o cubierto
very cloudy with rain and thunderstorms and fog=muy nublado con lluvia, tormentas y niebla
very cloudy with rain and thunderstorms=muy nublado con lluvia y tormentas
very heavy rain, locally flooding=lluvia muy intensa, inundaciones locales
very=muy
visibility=visibilidad
weather=clima
with=con