april=aprile
august=agosto
december=dicembre
february=febbraio
friday=venerdì
january=gennaio
july=luglio
june=giugno
march=marzo
may=maggio
monday=lunedì
november=novembre
october=ottobre
saturday=sabato
september=settembre
sunday=domenica
thursday=giovedì
tuesday=martedì
wednesday=mercoledì
almost clear=quasi sereno
almost=quasi
and=e
broken=rotto
clear or partly cloudy=sereno o parzialmente nuvoloso
clear with haze=sereno con foschia
clear with light haze=sereno con leggera foschia
clear=sereno
clearings=schiarite
cloudy or very cloudy=nuvoloso o molto nuvoloso
cloudy with extensive haze=nuvoloso con estesa foschia
cloudy with local openings=nuvoloso con aperture locali
cloudy=nuvoloso
drizzle=pioviggine
due=dovuto
extensive=estensivo
flooding=allagamento
fog=nebbia
foggy weather and very low visibility=tempo nebbioso e visibilità molto bassa
foggy weather=tempo nebbioso
foggy=nebbioso
freezing fog=nebbia gelata
freezing=gelo
gray sky due to low clouds=cielo grigio a causa di nuvole basse
gray=grigio
hail=grandine
half cloudy=mezzano nuvoloso
half=metà
haze=foschia
heavy rain=pioggia forte
heavy snow and fog=neve forte e nebbia
heavy=forte
high=alto
irregular clouds with heavy rain=nuvole irregolari con pioggia forte
irregular clouds with possible thunderstorm=nuvole irregolari con possibile temporale
irregular clouds with possible thunderstorms and fog=nuvole irregolari con possibili temporali e nebbia
irregular clouds with rain showers=nuvole irregolari con rovesci di pioggia
irregular clouds with snow showers=nuvole irregolari con rovesci di neve
irregular clouds with snow=nuvole irregolari con neve
irregular clouds with strong thunderstorm=nuvole irregolari con temporale forte
irregular clouds with thunderstorms=nuvole irregolari con temporali
irregular clouds with very heavy rain=nuvole irregolari con pioggia molto forte
irregular=irregolare
light=leggero
local=locale
low clouds with some clearings=nuvole basse con alcune schiarite
low=basso
mostly clear=principalmente sereno
mostly=principalmente
no precipitation=nessuna precipitazione
no=nessuna
openings=aperture
or=oppure
overcast with drizzle and fog=coperto con pioviggine e nebbia
overcast with drizzle=coperto con pioviggine
overcast with freezing rain=coperto con pioggia congelante
overcast with heavy snow of a blizzard nature and fog=coperto con neve forte di tipo bufera e nebbia
overcast with heavy snow of a blizzard nature=coperto con neve forte di tipo bufera
overcast with heavy snow=coperto con neve forte
overcast with light rain and fog=coperto con pioggia leggera e nebbia
overcast with light rain=coperto con pioggia leggera
overcast with light snow and fog=coperto con neve leggera e nebbia
overcast with light snow=coperto con neve leggera
overcast with possible rain and fog=coperto con possibile pioggia e nebbia
overcast with possible rain=coperto con possibile pioggia
overcast with rain and fog=coperto con pioggia e nebbia
overcast with rain mixed with snow=coperto con pioggia miscelata a neve
overcast with rain showers and fog=coperto con rovesci di pioggia e nebbia
overcast with rain showers=coperto con rovesci di pioggia
overcast with rain=coperto con pioggia
overcast with round snow showers=coperto con rovesci di neve rotondi
overcast with sleet and fog=coperto con pioggia mista a neve e nebbia
overcast with sleet=coperto con pioggia mista a neve
overcast with snow and fog=coperto con neve e nebbia
overcast with snow showers and fog=coperto con rovesci di neve e nebbia
overcast with snow showers=coperto con rovesci di neve
overcast with snow storms=coperto con tempeste di neve
overcast with snow=coperto con neve
overcast=coperto
partly cloudy=parzialmente nuvoloso
partly or partly cloudy with scattered haze=parzialmente o parzialmente nuvoloso con foschia sparsa
partly=parzialmente
possible=possibile
precipitation=precipitazione
rain=pioggia
reduced visibility due to fog banks=visibilità ridotta a causa di banchi di nebbia
round=tondo
scattered clouds and clearings=nuvole sparse e schiarite
scattered clouds with drizzle=nuvole sparse con pioviggine
scattered clouds with large clearings=nuvole sparse con ampie schiarite
scattered clouds with light rain=nuvole sparse con pioggia leggera
scattered clouds with light snow=nuvole sparse con neve leggera
scattered clouds with possible rain=nuvole sparse con possibile pioggia
scattered clouds with possible thunderstorms=nuvole sparse con possibili temporali
scattered clouds with rain=nuvole sparse con pioggia
scattered clouds with sleet=nuvole sparse con pioggia mista a neve
severe thunderstorms and fog=temporali forti e nebbia
severe thunderstorms with hail=temporali forti con grandine
severe thunderstorms=temporali forti
showers=rovesci
sky=cielo
sleet=pioggia mista a neve
slight precipitation=precipitazione leggera
slight=leggero
snow=neve
some=alcuni
storms=temporaloni
strong=forte
thin high clouds=nuvole alte sottili
thin=sottile
thunder=tuono
thunderstorm=temporale
to=per
very cloudy or overcast with high clouds=molto nuvoloso o coperto con nuvole alte
very cloudy or overcast=molto nuvoloso o coperto
very cloudy with rain and thunderstorms and fog=molto nuvoloso con pioggia, temporali e nebbia
very cloudy with rain and thunderstorms=molto nuvoloso con pioggia e temporali
very heavy rain, locally flooding=pioggia molto forte, con allagamenti locali
very=molto
visibility=visibilità
weather=meteo
with=con