april=aprilie
august=august
december=decembrie
february=februarie
friday=vineri
january=ianuarie
july=iulie
june=iunie
march=martie
may=mai
monday=luni
november=noiembrie
october=octombrie
saturday=sâmbătă
september=septembrie
sunday=duminică
thursday=joi
tuesday=marți
wednesday=miercuri
almost clear= aproape clar
almost= aproape
and= și
broken= spart
clear or partly cloudy= senin sau parțial înnorat
clear with haze= senin cu ceață
clear with light haze= senin cu ceață ușoară
clear= senin
clearings= deschideri
cloudy or very cloudy= înnorat sau foarte înnorat
cloudy with extensive haze= înnorat cu ceață extinsă
cloudy with local openings= înnorat cu deschideri locale
cloudy= înnorat
drizzle= măruntă
due= din cauza
extensive= extins
flooding= inundație
fog= ceață
foggy weather and very low visibility= vreme cu ceață și vizibilitate foarte scăzută
foggy weather= vreme cu ceață
foggy= cețos
freezing fog= ceață înghețată
freezing= înghețat
gray sky due to low clouds= cer gri din cauza norilor de joasă altitudine
gray= gri
hail= grindină
half cloudy= parțial înnorat
half= jumătate
haze= ceață
heavy rain= ploaie puternică
heavy snow and fog= zăpadă abundentă și ceață
heavy= puternic
high= înalt
irregular clouds with heavy rain= nori neregulați cu ploaie puternică
irregular clouds with possible thunderstorm= nori neregulați cu posibilă furtună
irregular clouds with possible thunderstorms and fog= nori neregulați cu posibile furtuni și ceață
irregular clouds with rain showers= nori neregulați cu averse
irregular clouds with snow showers= nori neregulați cu averse de zăpadă
irregular clouds with snow= nori neregulați cu zăpadă
irregular clouds with strong thunderstorm= nori neregulați cu furtună puternică
irregular clouds with thunderstorms= nori neregulați cu furtuni
irregular clouds with very heavy rain= nori neregulați cu ploaie foarte puternică
irregular= neregulat
light= ușor
local= local
low clouds with some clearings= nori de joasă altitudine cu câteva deschideri
low= jos
mostly clear= în mare parte senin
mostly= în mare parte
mostly= în mare parte
no precipitation= fără precipitații
no= nu
openings= deschideri
or= sau
overcast with drizzle and fog= înnorat cu măruntă și ceață
overcast with drizzle= înnorat cu măruntă
overcast with freezing rain= înnorat cu ploaie înghețată
overcast with heavy snow of a blizzard nature and fog= înnorat cu zăpadă abundentă de natură de furtună de zăpadă și ceață
overcast with heavy snow of a blizzard nature= înnorat cu zăpadă abundentă de natură de furtună de zăpadă
overcast with heavy snow= înnorat cu zăpadă abundentă
overcast with light rain and fog= înnorat cu ploaie ușoară și ceață
overcast with light rain= înnorat cu ploaie ușoară
overcast with light snow and fog= înnorat cu zăpadă ușoară și ceață
overcast with light snow= înnorat cu zăpadă ușoară
overcast with possible rain and fog= înnorat cu posibilă ploaie și ceață
overcast with possible rain= înnorat cu posibilă ploaie
overcast with rain and fog= înnorat cu ploaie și ceață
overcast with rain mixed with snow= înnorat cu ploaie amestecată cu zăpadă
overcast with rain showers and fog= înnorat cu averse și ceață
overcast with rain showers= înnorat cu averse
overcast with rain= înnorat cu ploaie
overcast with round snow showers= înnorat cu averse de zăpadă rotunde
overcast with sleet and fog= înnorat cu lapoviță și ceață
overcast with sleet= înnorat cu lapoviță
overcast with snow and fog= înnorat cu zăpadă și ceață
overcast with snow showers and fog= înnorat cu averse de zăpadă și ceață
overcast with snow showers= înnorat cu averse de zăpadă
overcast with snow storms= înnorat cu furtuni de zăpadă
overcast with snow= înnorat cu zăpadă
overcast= înnorat
overcast= înnorat
partly cloudy= parțial înnorat
partly or partly cloudy with scattered haze= parțial sau parțial înnorat cu ceață dispersată
partly= parțial
possible= posibil
precipitation= precipitații
precipitation= precipitații
rain= ploaie
reduced visibility due to fog banks= vizibilitate redusă din cauza băncilor de ceață
round= rotund
scattered clouds and clearings= nori dispersați și deschideri
scattered clouds with drizzle= nori dispersați cu măruntă
scattered clouds with large clearings= nori dispersați cu deschideri mari
scattered clouds with light rain= nori dispersați cu ploaie ușoară
scattered clouds with light snow= nori dispersați cu zăpadă ușoară
scattered clouds with possible rain= nori dispersați cu posibilă ploaie
scattered clouds with possible thunderstorms= nori dispersați cu posibile furtuni
scattered clouds with rain= nori dispersați cu ploaie
scattered clouds with sleet= nori dispersați cu lapoviță
severe thunderstorms and fog= furtuni severe și ceață
severe thunderstorms with hail= furtuni severe cu grindină
severe thunderstorms= furtuni severe
showers= averse
showers= averse
sky= cer
sleet= lapoviță
sleets= lapovițe
slight precipitation= precipitații ușoare
slight= ușor
snow= zăpadă
some= unele
storms= furtuni
strong= puternic
thin high clouds= nori subțiri și înalți
thin= subțire
thunder= tunet
thunderstorm= furtună
to= la
very cloudy or overcast with high clouds= foarte înnorat sau înnorat cu nori înalți
very cloudy or overcast= foarte înnorat sau înnorat
very cloudy with rain and thunderstorms and fog= foarte înnorat cu ploaie, furtuni și ceață
very cloudy with rain and thunderstorms= foarte înnorat cu ploaie și furtuni
very heavy rain, locally flooding= ploaie foarte puternică, cu inundații locale
very= foarte
visibility= vizibilitate
weather= vreme
with= cu